13 19 3 -3 -5 4
2 2 2 2 2 2 2 2 2 2 0 2 0 2 2 2 2 2 2 
2 2 2 2 2 2 2 2 2 2 0 2 0 2 2 2 2 2 2 
2 2 2 2 2 2 2 2 0 0 0 0 0 0 0 0 0 2 2 
2 2 2 2 2 2 2 2 2 2 2 2 0 2 2 2 2 2 2 
2 2 2 2 2 2 2 2 0 0 0 2 0 2 2 2 2 2 2 
2 2 2 2 2 2 2 2 2 2 1 2 0 2 2 2 2 2 2 
2 2 0 0 0 0 0 2 0 1 1 1 0 2 2 2 2 2 2 
2 2 2 2 0 2 2 2 2 2 1 2 2 2 2 2 2 2 2 
2 2 0 0 0 0 0 0 0 0 0 0 0 0 0 0 0 0 0 
2 2 0 2 0 2 2 2 2 2 2 2 2 2 0 2 2 2 2 
0 0 0 2 0 2 2 2 2 2 2 2 2 2 0 2 2 2 2 
2 2 0 2 2 2 2 2 2 2 2 2 2 2 2 2 2 2 2 
2 2 0 2 2 2 2 2 2 2 2 2 2 2 2 2 2 2 2 
28 11 
| | 
19 ¡Ð 13 ¡Ð 10 ¡Ð 18 ¡Ð 29 
| 
24 ¡Ð 15 6 
| | 
23 ¡Ð 9 ¡Ð 22 14 ¡Ð 0 ¡Ð 3 
| | 
8 ¡Ð 7 ¡Ð 5 ¡Ð 2 ¡Ð 1 ¡Ð 4 ¡Ð 12 ¡Ð 25 ¡Ð 26 
| | | 
27 ¡Ð 17 16 20 
| 
21 
